1111111111111111111
100000X000000000XP1
1011101110111010101
100C101C101C001C101
1X11101010111011101
1000000000000X00001
1011101110101011101
101E101C001C100C101
1010101110111011101
1X00000X00000000001
1111111111111111111
