11111111111
1P1C00000C1
10101111101
1010100C101
10101EX0101
10101110101
101C000C101
10111111101
1C0000000C1
11111111111
