11111
1E001
111X1
1P0C1
11111
