1111111111111111111111111111111111
1E000000X000000C00000C000000000001
1110111100100000101001000X00010101
1011010010101010001001000X00010101
1P0000000C00C000X000000000000000C1
1111111111111111111111111111111111
