111111111
1E001C0X1
1000X0001
111111101
1P00000C1
111111111
