111111111
1001000C1
11011E001
100010111
100P100001
111111111
