111111111
1E001C001
1A0010001
111011101
1P00000C1
111111111
