1111111111111111111
1P00000000000000001
1000000000000000001
100C00C00C00100C001
1000000000000000001
1000000000000000001
100100C00C00C00C001
1000000000000000001
1000000000000000001
100C00C00C00C001001
1000000000000000001
1000000000000000001
100C00100C00C00C001
1000000000000000001
10000000000000000E1
1111111111111111111
