111111111111111111111111111
1111111111111111E1111111111
100000000000111100000000001
101111111110C11111111111101
101111111110111111111111101
1011111111C0111111111110001
101111111110011111111110111
1011111111110C1111111110011
101111111111011111111111011
10111111111C011111111111011
101111111111001111111111011
10111111111110C111111111011
101111111111001111111111011
10111111111C011111111111011
101111111111000000111111011
1P1111111111111110000000011
111111111111111111111111111
