11111111111111111111111111
1E000000000001000000010001
1111110111110X011111010X01
10000100000100010001000101
1P1100111C1011100X01110101
11111000010100000101C11101
1C0000X00000011C1100000001
11111111111111111111111111
