11111111111111111111111111
1P0000000000000000000000C1
10010101110100010001110001
10010101000100010001010001
10011101100100010001010001
10010101000100010001010001
10010101110111011101110E01
1C000000000000000000000001
11111111111111111111111111
