11111111111111111111111111
1P00000000000000X000X00XC1
1001010111010X010001110001
100101010001000100010100X1
1001110110X1X0X10001010001
10X10101000100010001010X01
1X0101X111011101110111XE01
1C00000000000X0000000000X1
11111111111111111111111111
