11111111
1P000001
10010001
1C010111
100C1101
10000101
10000E01
11111111
