11111111
1P0000X1
10010001
1C01B111
100C1101
10000101
1X000E01
11111111
