1111111111111
100000000X001
1P00011100001
10001CCC10001
1001C000C1001
1001C0E0C1001
1001C000C1001
10001C0C10001
1000010100001
10000X00000B1
1111111111111
