1111111111111111111
10000000000000000P1
1011101110111010101
100C101C101C001C101
1011101010111011101
1000000000000000001
1011101110101011101
101E101C001C100C101
1010101110111011101
1000000000000000001
1111111111111111111
