111111111111111
1P00001C1110C11
10101C1011101E1
1C1011100000101
11100C1C0110001
1C1C11111100111
101010000110011
101000110001001
100011C00100011
1111111011101C1
1C11C1000100001
100000011111011
1C11100C1C00011
111111111111111
