111111111111111
1P00001C1110C11
10101C1011X01E1
1C1011100000X01
11100C1C0110001
1C1C11111100X11
101010000110011
10X00011000X001
100011C00100011
1111111011101C1
1C11C1000100001
10000001111X0X1
1CX1100C1C00011
111111111111111
