1111111111111111111
1P0000000X000000001
1000000000000000001
100C00C00C00100C001
1000000000000000001
1000000000000000001
100100C00C00C0XC001
1000000000000000001
100000000X000000001
100C00C00C00C001001
1000000000000000001
1000000000000000001
100CX0100C00C00C001
1000000000000000001
100000000B0000000E1
1111111111111111111
