11111
1E001
111C1
1P001
11111
