11111111111111111111111111
1E000000000001000000010001
11111101111101011111010101
10000100000100010001000101
1P1100111C1011100101110101
11111000010100000101C11101
1C0000100000011C1100000001
11111111111111111111111111
