1111111111111111111111111111111111
1E0000000000000C10000C000000000001
1111011100111110001001000000010101
1010110011000001110001000000010101
1P0000000C01C1000000000000000000C1
1111111111111111111111111111111111
