111111111111111111111111111111
100000000000000011111000100C11
100000000000000001111010001001
100000000000000001110C11111101
1P00000C0000C0000C0001111000C1
1000000000000000011111000C1111
100000000000000011111101111111
1000000000000001111111C0000001
1100000000000011111111111111C1
111110000111111111111000000001
111111111111111111110C11111111
11111111111111111111011100C001
111111111111101111110111011101
1111111110000000000000C0011101
1111111110111111111111111110C1
11111110001111111111E00C000011
111111111111111111111111111111
