111111111111111111111111111
1X11111111111111E11111111X1
100000000000X11X00000000001
10X111111110C11111111111101
1011111111X0X1111111111X101
1011111111C0111111111110001
1011111111X00X1111111110X11
1011111111110C11111111X0011
10111111111X0X1111111111011
10111111111C011111111111011
10111111111X00X111111111011
10111111111110C111111111011
10111111111X00X111111111011
10111111111C0X1111111111011
101111111111000000X11111011
1P1111111111X111100000000X1
111111111111111111111111111
