1111111111111111111111111
1C1111111111P1111111111C1
10000X000000000000X000X01
1X0X0000000000000000X0001
10010010010010010010010X1
10X0000000000000000000001
10000000000X0X00000000001
100100100100C001001001001
10000000000X0X00000000001
10X0000000000000000000X01
1001001001001001001001001
1X0X000000000000000X000X1
100010000000000000000X001
1C1111111111E1111111111C1
1111111111111111111111111
