1111111111111111111111111
10000000000001111111111E1
1011111111110C11111111101
1011111111100111111111101
1011111111C01111111111101
1011111111100111111111101
1011111111110C11111111101
1011111111100111111111101
1011111111C01111111111101
1011111111100111111111101
1011111111110C11111111101
1011111111100111111111101
1011111111C01111111111101
1P11111111100000000000001
1111111111111111111111111
