1111111111111111111111111
1C1111111111P1111111111C1
1000000000000000000000001
1000000000000000000000001
1001001001001001001001001
1000000000000000000000001
1000000000000000000000001
100100100100C001001001001
1000000000000000000000001
1000000000000000000000001
1001001001001001001001001
1000000000000000000000001
1000000000000000000000001
1C1111111111E1111111111C1
1111111111111111111111111
