111111111
1E001C001
100010001
111011111
1P00000C1
111111111
